000111222000111222000111222000111222000111222
011112220000111222000111222000111222000111222
000111000000111222000111222000111222000111222
222000111000111222000111222000111222000111222
000111222000111222000111222000111222000111222
011112220000111222000111222000111222000111222
000111000000111222000111222000111222000111222
222000111000111222000111222000111222000111222
000111222000111222000111222000111222000111222
011112220000111222000111222000111222000111222
000111000000111222000111222000111222000111222
222000111000111222000111222000111222000111222
